direction=RIGHT
length=3
head=3,1
size=10x10
target=10
..........
..........
..........
........X.
........X.
........X.
........X.
..........
..........
..P.....A.