head=5,5
length=3
direction=DOWN
target=20
size=20x10
XXXXXXXXXXXXXXXXXXXX
X..................X
X..................X
X..............A...X
X..................X
X..................X
X..................X
X..................X
X..................X
XXXXXXXXXXXXXXXXXXXX